11111111111
1000C001001
10001111101
10000000001
100000000P1
1E000000001
10000000001
11111111111
