11111111
10C1E001
10C0C011
10P10001
11111111
