1111111111111111111111111111111111
10C1E000000C0000000000000000000011
10C0C0100C100111111111111111110111
10P100111C00C000000011111111111111
1111111111111111111111111111111111
