11111111111111
10C1E000000001
10C0C010001001
10P10011100001
11111111111111
