1111111111111111111
10C1E000000C0000011
10C0C0100C100111111
10P100111C00C000001
1111111111111111111
