11111111111111
10C1E000000C01
10C0C0100C1001
10P100111C00C1
11111111111111
